NO ./textures/wall_north.xpm
SO ./textures/wall_south.xpm
WE ./textures/wall_west.xpm
EA ./textures/wall_east.xpm
F 110,90,60
C 135,206,235

1111111111111111111111111111111111111111111
1000000000000000000000000000000000000000001
1011111111111111111111111111111111111111101
1010000000000000000000000000000000000000101
1010111111111111111111111111111111111110101
1010100000000000000000000000000000000010101
1010101111111111111111111111111111111010101
1010101000000000000000000000000000010010101
1010101011111111111111111111111111010010101
1010101010000000000000000000000001010010101
1010101010111111111111111111111101010010101
1010101010100000000000000000000101010010101
1010101010101111111111111111100101010010101
1010101010101000000000000000100101010010101
1010101010101011111111111110100101010010101
1010101010101010000000000010100101010010101
1010101010101010111111111010100101010010101
1010101010101010100000001010100101010010101
1010101010101010101111101010100101010010101
1010000010000010100000100010000000010010001
1011111011111010111110111110111111011111101
1000000000000010000000000000100000000000001
1111111111111111111111111111111111111111111
