NO ./textures/wall_north.xpm
SO ./textures/wall_south.xpm
WE ./textures/wall_west.xpm
EA ./textures/wall_east.xpm
F 90,70,50
C 120,180,255

1111111111111111111111111111111
1000000000000000000000000000001
1011111111110111111111111111101
1010000000010100000000000000101
1010111111010101111111111110101
1010100000010101000000000010101
1010101111110101011111111010101
1010101000000001010000001010101
1010101011111111010111101010101
1010101010000000010100001010101
1010101010111111110101111010101
1010000010000000000000000010001
1011111111111111111111111111101
1000000000000000N00000000000001
1111111111111111111111111111111
