NO ./textures/wall_north.xpm
SO ./textures/wall_south.xpm
WE ./textures/wall_west.xpm
EA ./textures/wall_east.xpm
F 101,67,33
C 135,206,235

11111111111111
1000C0O000001
1011111111101
101000C000101
1011101110101
101N00O00O01
1011111111101
1000000000001
11111111111111
