NO ./textures/wall_north.xpm
SO ./textures/wall_south.xpm
WE ./textures/wall_west.xpm
EA ./textures/wall_east.xpm

F 50,50,50
C 200,220,255

        1111111111111
        1000000000001
111111111011111111110111111
100000000010000000010000001
101111111110111111010111101
101000000000100000010100001
101011111111101111110101111
101010000000001000000101001
101010111111111011111101001
101010100000000010000001001
101010101111111110111111001
101000001000000000100000001
101111111011111111101111101
1000000000100000000000000N1
111111111111111111111111111
