NO ./textures/wall_north.xpm
SO ./textures/wall_south.xpm
WE ./textures/wall_west.xpm
EA ./textures/wall_east.xpm

F 80,60,40
C 160,200,255

111111111111111111111111111
100000000010000000000000001
101111111010111111111111101
101000001010100000000000101
101011101010101111111110101
101010001010101000000010101
101010111010101011111010101
101010100010101010001010101
101010101110101010101010101
101010100000101010101000101
101010111111101010101111101
101000000000001010000000001
101111111111101011111111101
1000000000000010000000000N1
111111111111111111111111111
