NO ./textures/wall_north.xpm
SO ./textures/wall_south.xpm
WE ./textures/wall_west.xpm
EA ./textures/wall_east.xpm
F 101,67,33
C 135,206,235

111111
100101
100001
1100N1
111111
